1111111111111111111111111111111
1C0PE00000000000000000000000001
1111111111111111111111111111111
