1111111111111111111111111111111
1CPE000000000CCCCCCCC00000000C1
1000000000000CCCCCCCC00000000C1
1111111111111111111111111111111
1111111111111111111111111111111
