1111111111111111111111111111111
1E1000000000000C00000C000000011
1010010100100000101001000101011
1						      1
1P0000000C00C000000000000000C11
1010010010101010001001000101011
1C0000000C00C000000000000000C11
1010010010101010001001000101011
1C0000000C00C000000000000000C11
1010010010101010001001000101011
100000000C00C000000000000000C11
1010010010101010001001000101011
100000000C00C000000000000000C11
1010010010101010001001000101011
1C0000000C00C000000000000000C11
1010010010101010001001000101011
1C0000000C00C000000000000000C11
1111111111111111111111111111111
