111111111
100000001
10E0P0001
10C000001
111111111
