1111111111111111111111111111111
1E000000000P000000000000CC00011
1111111111111111111111111111111
