1111111111111111111111111111111
1E000000000P000C00000C000000011
1111111111111111111111111111111
