111111111111
1000000C0011
1P0000E00001
111111111111
111111111111
111111111111
