111111111111111111111111111
1CCCCCCCCC00000000000000001
1P1001010010000100001010101
101001001010101000010001011
10001E000C00C000000000000C1
111111111111111111111111111
