1111111111111
100100C1000C1
100C001110011
100C0C00000E1
10P10001000C1
1111111111111
