1111111111111111111111111111111
1EPCC11111111111111111111111111
1111111111111111111111111111111
