1111111111111111111111111111111
1CP0000000000CCCCCCCC0001E00001
1000000000000CCCCCCCC0000000001
1111111111111111111111111111111
1111111111111111111111111111111
